R 1680 1050
S /Users/lulu/Lryst/Cub3D/ressources/barrel.xpm

    NO /Users/lulu/Lryst/Cub3D/ressources/tex_mur_brique.xpm
SO /Users/lulu/Lryst/Cub3D/ressources/texture_mur_fleurs-_1_.xpm





    WE /Users/lulu/Lryst/Cub3D/ressources/texture_mur_pierre.xpm
EA /Users/lulu/Lryst/Cub3D/ressources/texture_mur_pierre_grises.xpm

F 250,100,0
C 225,30,0



    1111111111111111111
11111111100000000000001111111111111111111
10000000001100000000000000201
10110000011102020200200010001
1001000000000000000200001000111111
10110000011100000200S0001000000001
1000000000110000011101111000111101
1111011111111101110002011111111001
1111110110100111111011111111110011
1100000011010101110000001110000111
1000200000000000000000000000111111
10000000000000001101010010001
11000000110101011111011110001
11110111111111011111011110001
11111111111111111111111111111