R 1920 1080
S ./path_to_the_sprite_texture

    NO ./path_to_the_north_texture
SO ./path_to_the_south_texture






    WE				./path_to_the_west_texture
EA ./path_to_the_east_texture

F 250,100,0
C 225,30,0






11111111111111111111111111111
10000000001100000000000000001
10110000011100000020000010001
1001000000000000000N000010001
10110000011100000000000010001
10000000001100000111011110001
11110111111111011100000011111
11111101101001111110111111111
11000000110101011100000011111
10002000000000000000000000001
10000000000000001101010010001
11000000110101011111011110001
11110111111101011111011110001
11111111111111111111110111111