R 1680 1050
S /Users/lulu/Lryst/Cub3D/ressources/barrel.xpm

    NO /Users/lulu/Lryst/Cub3D/ressources/tex_mur_brique.xpm
SO /Users/lulu/Lryst/Cub3D/ressources/texture_mur_fleurs-_1_.xpm






    WE /Users/lulu/Lryst/Cub3D/ressources/texture_mur_pierre.xpm
EA /Users/lulu/Lryst/Cub3D/ressources/texture_mur_pierre_grises.xpm

F 250,100,0
C 225,30,0




11111111111111111111111111111
10000000001100000000000000201
10110000011122222222200010001
100100000000000000N0000010001
10110000011100000000000010001
10000000001100000111011110001
11110111111111011100020111111
11111101101001111110111111111
11000000110101011100000011111
10002000000000000000000000001
10000000000000001101010010001
11000000110101011111011110001
11110111111101011111011110001
11111111111111111111111111111